Dataset name,Features,Instances,Minority,Majority,Imbalance Ratio
Breast,9,106,36,70,1.94
Ecoli,7,336,52,284,5.46
Eucalyptus,8,642,98,544,5.55
Glass,9,214,70,144,2.06
Haberman,3,306,81,225,2.78
Heart,13,270,120,150,1.25
Iris,4,150,50,100,2.00
Libra,90,360,72,288,4.00
Liver,6,345,145,200,1.38
Pima,8,768,268,500,1.87
Segment,16,2310,330,1980,6.00
Vehicle,18,846,199,647,3.25
Wine,13,178,71,107,1.51
